                 ###
                ## ##
               ##   ##
              ##     ##
             ##       ##
            ##         ##
           ##           ##
          ##             ##
          #               #
          ##             ##
           ##           ##
            ##         ##
             ##       ##
              ##     ##
               ##   ##
                ##  #
                 ## #
                  # #
            ###   # #
            # ##  # #
            ## ## # #
             ## ### #
              ##    #
               #### #
                  # #
                  # #
                  ###

