
                              ###
                             ## ##
           ###              ##   ##
          ## ##            ##     ##
         ##   ###         ##       ##
        ##      ###      ##         ##
       ##         ###   ##           ##
      ##            ## ##             #
      #              ###             ##
      ##                            ##
       ##                          ##
        ##                        ##
         ##                      ##
          ##                    ##
           ##                  ##
            ##                ##
             ##              ##
              ##            ##
               ##          ##
                ##        ##
                 ##      ##
                  ##    ##
                   ##  ##
                    ####



